NO  ./sprites/xpm_images/lsd.xpm
SO  ./sprites/xpm_images/craa.xpm
WE  ./sprites/xpm_images/lsd.xpm
EA  ./sprites/xpm_images/craa.xpm

F 255,000,000
C 000,000,255
  
1111111111111111111
1000000001000000001
1000000000100000001
100000E000000000001
1000000000010000001
1000000000100000001
1111111111111111111
